NO ./textures/colorstone.xpm
SO ./textures/greystone.xpm
WE ./textures/redbrick.xpm
EA ./textures/wood.xpm

F 255, 207, 251
C 179, 245, 240

111111111111
100000100011
101100N10111
100100000001
111111111111
